0419FBEF 01000700
0419FBFF 01000700
0419FC1F 01000700
0419FC0F 01000700
0419FD6F 01000700
0419FC6F 01000700
0419FD4F 01000700
0419FC3F 01000700
0419FC8F 01000700
0419FCAF 01000700
0419FC4F 01000700
0419FCCF 01000700
0419FCDF 01000700
0419FCEF 01000700
0419FD0F 01000700
0419FD1F 01000700
0419FD2F 01000700
0419FC2F 01000700
0419FC7F 01000700
0419FC9F 01000700
0419FCBF 01000700
0419FCFF 01000700
0419FD4F 01000700
0419FD5F 01000700
0419FD7F 01000700
0419FD8F 01000700
0419FD3F 01000700
0813980C 00000000
0013980C 00000001
